#########################
#.........#.#...#...#...#
#.#######.#...#...#...#.#
#.......#.#.####.######.#
#.#####.#......#.#......#
#.#.....#.####.#.#.####.#
#.#.###.#.#....#.#.#....#
#.#.#...#.######.#.####.#
#.#.#.###.#......#.#....#
#.#.#.#.#.####.###.####.#
#.#.#.#........#.#......#
#.#.#.###.####.#.#.####.#
#.#.#.#...#.P..#.#.#..###
#.#.#.###.##.###.#.##.#.#
#.#.#.#...#.............#
#.###.###.###.####.####.#
#.......#.#.#....#....#.#
#.#####.#.#.#.#########.#
#.......................#
#########################
