#########################
#                       #
# ######                #
#      #                #
# #### #                #
# #  # #                #
# # ## #                #
# #  ####               #
#       #               #
#       #               #
#                       #
# # # # # # # # # # # # #
#           P           #
#                       #
#                       #
#                       #
#                       #
#                       #
#                       #
#########################
