#########################
#.........#.#...#...#...#
#.#######.#...#...#...#.#
#.......#.#.####.######.#
#.#####.#......#.#......#
#.#.....#.####.#.#.####.#
#.#.###.#......#.#......#
#.#.#...#.######.#.####.#
#.#.#.#.#........#......#
#.#.#.#.#.####.#.#.####.#
#.#.#.#........#.#......#
#.#.#.###.####.#.#.####.#
#.#.#.......P..#.#....#.#
#.#.#.###.######.#.##.#.#
#.#.#.....#.............#
#.#.#.###.#.#.####.####.#
#.......#.#.#...........#
#.#####.#.#.#.#########.#
#.......................#
#########################
