#########################
#.........#.#...#...#...#
#.#######.#...#...#...#.#
#.......#.#.####.######.#
#######.#......#.#......#
#.......#.####.#.#.######
#.#.###.#......#.#......#
#.#.#...#.######.######.#
#.#.#.#.#........#......#
#.#.#.#.#.####.#.#.######
#.#.#.#........#.#......#
#.#.#.###.####.#.#.####.#
#.#.#.......P..#.#....#.#
#.#.#####.######.#.##.#.#
#...#.....#.............#
###.#.###.#.#.####.######
#.......#.#.#...........#
#.#####.#.#.#.#########.#
#.......#...#...........#
#########################
