#########################
#         # #   #   #   #
# ####### #   #   #   # #
#       # # #### ###### #
# ##### #      # #      #
# #     # #### # # #### #
# # ### # #    # # #    #
# # #   # ###### # #### #
# # # ### #      # #    #
# # # # # #### ### #### #
# # # #........# #      #
# # # ###.#### # # #### #
# # # #...# P  # # #  ###
# # # ### ## ### # ## # #
# # # #   #             #
# ### ### ### #### #### #
#       # # #    #    # #
# ##### # # # ######### #
#                       #
#########################
